さかな : pescado
つくえ : escritorio
さる : mono
ほし : estrella
いす : silla
うち : casa
かさ : paraguas
はな : nariz
じゅう : 10
かばん : bolso
くつ : zapato
あし : pie
て : mano
は : diente
め : ojo
おちゃ : te verde
ちょう : mariposa
せんせい : maestro
ろっぴゃく : 600
はっぴゃく : 800
ひゃく : 100
くち : boca
びょうき : enfermo
びょういん : hospital
うし : vaca 
うま : caballo
やま : montana
ぎゅうにゅう : leche de vaca
ぎゅうにく : carne de vaca
じてんしゃ : bicicleta
えんぴつ : lapiz
でんわ : telefono
めがね : lentes
ほん: libro
おじいさん : abuelo
おばあさん : abuela
おとうさん : padre
おかあさん : madre
おにいさん : hermano mayor
おねえさん : hermana mayor
おとうと : hermano menor
いもうと : hermana menor
すいか : sandia
じゅうどう : judo
にんぎょう : muneca
がっこう : escuela
さとう : azucar
れいぞうこ : heladera
せっけん : jabon
ひこうき : avion
しお : sal
おさら : plato
おはし : palillo
ひ : fuego
かじ : incendio
みず : agua
かぜ : viento
かぎ : llave
ごはん : comida
まど : ventana
ぶた : cerdo
きっぷ : boleto
きって : estampilla
いぬ : perro
ねこ : gato
みみ : oreja
